000000000000000
000000000000000
000000000000000
000111111111000
000100000000000
000100000000000
000100000000000
000100000000000
000100000000000
000100000000000
000100000000000
000100000000000
000100000000000
000100000000000
000100000000000
000100000000000
000111111111111
000000000000000
000000000000000
000000000000000